93,49,160,
0,0,0,0,0,0,0,0,0,0,0,0,0,0,0,0,0,0,0,0,0,0,0,0,0,0,0,0,0,0,0,0,0,0,0,0,0,0,0,0,0,0,0,0,0,0,0,0,0,0,0,0,0,0,0,0,0,0,0,0,0,0,0,0,0,0,0,0,0,0,0,0,0,0,0,0,0,0,0,0,0,0,0,0,0,0,0,0,0,0,0,0,0,0,0,0,0,0,0,0,0,0,0,0,0,0,0,0,0,0,0,0,0,0,0,0,0,0,0,0,0,0,0,0,0,0,0,0,0,0,0,0,0,0,0,0,0,0,0,0,0,0,0,0,0,0,0,0,0,0,0,0,0,0,0,0,0,0,0,0,
0,0,0,0,0,0,0,0,0,0,0,0,0,0,0,0,0,0,0,0,0,0,0,0,0,0,0,0,0,0,0,0,0,0,0,0,0,0,0,0,0,0,0,0,0,0,0,0,0,0,0,0,0,0,0,0,0,0,0,0,0,0,0,0,0,0,0,0,0,0,0,0,0,0,0,0,0,0,0,0,0,0,0,0,0,0,0,0,0,0,0,0,0,0,0,0,0,0,0,0,0,0,0,0,0,0,0,0,0,0,0,0,0,0,0,0,0,0,0,0,0,0,0,0,0,0,0,0,0,0,0,0,0,0,0,0,0,0,0,0,0,0,0,0,0,0,0,0,0,0,0,0,0,0,0,0,0,0,0,0,
0,0,0,0,0,0,0,0,0,0,0,0,0,0,0,0,0,0,0,0,0,0,0,0,0,0,0,0,0,0,0,0,0,0,0,0,0,0,0,0,0,0,0,0,0,0,0,0,0,0,0,0,0,0,0,0,0,0,0,0,0,0,0,0,0,0,0,0,0,0,0,0,0,0,0,0,0,0,0,0,0,0,0,0,0,0,0,0,0,0,0,0,0,0,0,0,1,2,3,4,5,6,3,4,5,6,3,4,5,6,3,4,5,6,3,4,5,6,7,8,7,9,7,7,5,6,3,4,5,6,3,4,5,6,3,4,5,6,3,4,5,6,3,4,7,8,10,7,5,6,3,4,5,6,3,4,5,6,11,12,
0,0,0,0,0,0,0,0,0,0,0,0,0,0,0,0,0,0,0,0,0,0,0,0,0,0,0,0,0,0,0,0,0,0,0,0,0,0,0,0,0,0,0,0,0,0,0,0,0,0,0,0,0,0,0,0,0,0,0,0,0,0,0,0,0,0,0,0,0,0,0,0,0,0,0,0,0,0,0,0,0,0,0,0,0,0,0,0,0,0,0,0,0,0,0,0,13,14,15,16,17,18,15,16,17,18,15,16,17,18,15,16,17,18,15,16,17,18,7,19,7,20,7,7,17,18,15,16,17,18,15,16,17,18,15,16,17,18,15,16,17,18,15,16,7,19,21,7,17,18,15,16,17,18,15,16,17,18,22,23,
0,0,0,0,0,0,0,0,0,0,0,0,0,0,0,0,0,0,0,0,0,0,0,0,0,0,0,0,0,0,0,0,0,0,0,0,0,0,0,0,0,0,0,0,0,0,0,0,0,0,0,0,0,0,0,0,0,0,0,0,0,0,0,0,0,0,0,0,0,0,0,0,0,0,0,0,0,0,0,0,0,0,0,0,0,0,0,0,0,0,0,0,0,0,0,0,1,2,24,24,24,24,24,24,24,24,24,24,24,24,24,24,24,24,24,24,24,24,7,8,7,9,7,7,24,24,24,24,24,24,24,24,24,24,24,24,24,24,24,24,24,24,24,24,7,8,10,7,24,24,24,24,24,24,24,24,24,24,11,12,
0,0,0,0,0,0,0,0,0,0,0,0,0,0,0,0,0,0,0,0,0,0,0,0,0,0,0,0,0,0,0,0,0,0,0,0,0,0,0,0,0,0,0,0,0,0,0,0,0,0,0,0,0,0,0,0,0,0,0,0,0,0,0,0,0,0,0,0,0,0,0,0,0,0,0,0,0,0,0,0,0,0,0,0,0,0,0,0,0,0,0,0,0,0,0,0,1,2,25,26,17,20,25,26,17,20,25,26,17,20,25,26,17,20,25,26,17,20,7,19,7,20,7,7,17,20,25,26,17,20,25,26,17,20,25,26,17,20,25,26,17,20,25,26,7,19,21,7,17,20,25,26,17,20,25,26,17,20,11,12,
0,0,0,0,0,0,0,0,0,0,0,0,0,0,0,0,0,0,0,0,0,0,0,0,0,0,0,0,0,0,0,0,0,0,0,0,0,0,0,0,0,0,0,0,0,0,0,0,0,0,0,0,0,0,0,0,0,0,0,0,0,0,0,0,0,0,0,0,0,0,0,0,0,0,0,0,0,0,0,0,0,0,0,0,0,0,0,0,0,0,0,0,0,0,0,0,1,27,3,4,5,6,3,4,5,6,3,4,5,6,3,4,5,6,3,4,5,6,28,29,30,31,7,7,24,24,24,24,24,24,24,24,24,24,24,24,24,24,24,24,24,24,24,24,7,8,10,7,5,6,3,4,5,6,3,4,5,6,32,12,
0,0,0,0,0,0,0,0,0,0,0,0,0,0,0,0,0,0,0,0,0,0,0,0,0,0,0,0,0,0,0,0,0,0,0,0,0,0,0,0,0,0,0,0,0,0,0,0,0,0,0,0,0,0,0,0,0,0,0,0,0,0,0,0,0,0,0,0,0,0,0,0,0,0,0,0,0,0,0,0,0,0,0,0,0,0,0,0,0,0,0,0,0,0,0,0,33,2,15,16,17,18,15,16,17,18,15,16,17,18,15,16,17,18,15,16,17,18,34,24,35,36,7,7,25,26,17,20,25,26,17,20,25,26,17,20,25,26,17,20,25,26,17,20,7,19,21,7,17,18,15,16,17,18,15,16,17,18,11,37,
0,0,0,0,0,0,0,0,0,0,0,0,0,0,0,0,0,0,0,0,0,0,0,0,0,0,0,0,0,0,0,0,0,0,0,0,0,0,0,0,0,0,0,0,0,0,0,0,0,0,0,0,0,0,0,0,0,0,0,0,0,0,0,0,0,0,0,0,0,0,0,0,0,0,0,0,0,0,0,0,0,0,0,0,0,0,0,0,0,0,0,0,0,0,0,0,1,2,38,39,40,9,38,39,40,9,41,29,29,29,29,29,29,30,38,39,40,9,7,8,7,36,7,42,40,9,38,39,40,9,41,29,29,29,29,29,29,30,38,39,40,9,38,39,7,8,10,7,40,9,38,39,40,9,43,29,30,31,11,12,
0,0,0,0,0,0,0,0,0,0,0,0,0,0,0,0,0,0,0,0,0,0,0,0,0,0,0,0,0,0,0,0,0,0,0,0,0,0,0,0,0,0,0,0,0,0,0,0,0,0,0,0,0,0,0,0,0,0,0,0,0,0,0,0,0,0,0,0,0,0,0,0,0,0,0,0,0,0,0,0,0,0,0,0,0,0,0,0,0,0,0,0,0,0,0,0,44,45,25,26,17,20,25,26,17,20,46,47,47,47,47,47,47,48,25,26,17,20,7,19,7,49,7,50,17,20,25,26,17,20,46,47,47,47,47,47,47,48,25,26,17,20,25,26,7,19,21,7,17,20,25,26,17,20,51,19,52,53,11,12,
0,0,0,0,0,0,0,0,0,0,0,0,0,0,0,0,0,0,0,0,0,0,0,0,0,0,0,0,0,0,0,0,0,0,0,0,0,0,0,0,0,0,0,0,0,0,0,0,0,0,0,0,0,0,0,0,0,0,0,0,0,0,0,0,0,0,0,0,0,0,0,0,0,0,0,0,0,0,0,0,0,0,0,0,0,0,0,0,0,0,0,0,0,0,0,0,54,55,56,57,56,57,56,57,41,29,58,47,47,48,29,30,59,59,59,59,59,59,60,57,56,57,56,57,56,57,41,29,29,29,58,47,47,47,47,47,47,48,61,29,29,30,56,57,56,57,56,57,56,57,56,62,59,59,63,8,64,53,65,12,
0,0,0,0,0,0,0,0,0,0,0,0,0,0,0,0,0,0,0,0,0,0,0,0,0,0,0,0,0,0,0,0,0,0,0,0,0,0,0,0,0,0,0,0,0,0,0,0,0,0,0,0,0,0,0,0,0,0,0,0,0,0,0,0,0,0,0,0,0,0,0,0,0,0,0,0,0,0,0,0,0,0,0,0,0,0,0,0,0,0,0,0,0,0,0,0,66,67,68,67,68,67,68,67,69,47,47,47,47,47,47,48,53,53,53,53,53,53,53,70,68,67,68,67,68,67,69,47,47,47,47,47,47,47,47,47,47,47,47,47,47,48,68,67,68,67,68,67,68,67,68,71,72,53,63,19,52,53,68,73,
0,0,0,0,0,0,0,0,0,0,0,0,0,0,0,0,0,0,0,0,0,0,0,0,0,0,0,0,0,0,0,0,0,0,0,0,0,0,0,0,0,0,0,0,0,0,0,0,0,0,0,0,0,0,0,0,0,0,0,0,0,0,0,0,0,0,0,0,0,0,0,0,0,0,0,0,0,0,0,0,0,0,0,0,0,0,0,0,0,0,0,0,0,0,0,0,74,75,76,75,76,75,76,75,76,75,76,75,76,75,77,53,53,53,53,53,53,53,53,78,76,75,76,75,76,75,76,75,76,75,76,75,76,75,76,75,76,75,76,75,76,75,76,75,76,75,76,75,76,75,76,75,77,53,63,8,64,53,76,79,
0,0,0,0,0,0,0,0,0,0,0,0,0,0,0,0,0,0,0,0,0,0,0,0,0,0,0,0,0,0,0,0,0,0,0,0,0,0,0,0,0,0,0,0,0,0,0,0,0,0,0,0,0,0,0,0,0,0,0,0,0,0,0,0,0,0,0,0,0,0,0,0,0,0,0,0,0,0,0,0,0,0,0,0,0,0,0,0,0,0,0,0,0,0,0,0,0,0,0,0,0,0,0,0,0,0,0,0,0,0,0,0,0,0,0,0,0,0,0,0,0,0,0,0,0,0,0,0,0,0,0,0,0,0,0,0,0,0,0,0,0,0,0,0,0,0,0,0,0,0,0,0,0,0,63,19,52,0,0,0,
0,0,0,0,0,0,0,0,0,0,0,0,0,0,0,0,0,0,0,0,0,0,0,0,0,0,0,0,0,0,0,0,0,0,0,0,0,0,0,0,0,0,0,0,0,0,0,0,0,0,0,0,0,0,0,0,0,0,0,0,0,0,0,0,0,0,0,0,0,0,0,0,0,0,0,0,0,0,0,0,0,0,0,0,0,0,0,0,0,0,0,0,0,0,0,0,0,0,0,0,0,0,0,0,0,0,0,0,0,0,0,0,0,0,0,0,0,0,0,0,0,0,0,0,0,0,0,0,0,0,0,0,0,0,0,0,0,0,0,0,0,0,0,0,1,2,3,4,7,8,7,9,5,6,63,8,64,53,11,12,
0,0,0,0,0,0,0,0,0,0,0,0,0,0,0,0,0,0,0,0,0,0,0,0,0,0,0,0,0,0,0,0,0,0,0,0,0,0,0,0,0,0,0,0,0,0,0,0,0,0,0,0,0,0,0,0,0,0,0,0,0,0,0,0,0,0,0,0,0,0,0,0,0,0,0,0,0,0,0,0,0,0,0,0,0,0,0,0,0,0,0,0,0,0,0,0,0,0,0,0,0,0,0,0,0,0,0,0,0,0,0,0,0,0,0,0,0,0,0,0,0,0,0,0,0,0,0,0,0,0,0,0,0,0,0,0,0,0,0,0,0,0,0,0,13,14,15,16,7,19,7,20,17,18,63,19,52,53,22,23,
0,0,0,0,0,0,0,0,0,0,0,0,0,0,0,0,0,0,0,0,0,0,0,0,0,0,0,0,0,0,0,0,0,0,0,0,0,0,0,0,0,0,0,0,0,0,0,0,0,0,0,0,0,0,0,0,0,0,0,0,0,0,0,0,0,0,0,0,0,0,0,0,0,0,0,0,0,0,0,0,0,0,0,0,0,0,0,0,0,0,0,0,0,0,0,0,0,0,0,0,0,0,0,0,0,0,0,0,0,0,0,0,0,0,0,0,0,0,0,0,0,0,0,0,0,0,0,0,0,0,0,0,0,0,0,0,0,0,0,0,0,0,0,0,1,2,38,39,7,8,7,9,40,9,80,8,64,53,11,12,
0,0,0,0,0,0,0,0,0,0,0,0,0,0,0,0,0,0,0,0,0,0,0,0,0,0,0,0,0,0,0,0,0,0,0,0,0,0,0,0,0,0,0,0,0,0,0,0,0,0,0,0,0,0,0,0,0,0,0,0,0,0,0,0,0,0,0,0,0,0,0,0,0,0,0,0,0,0,0,0,0,0,0,0,0,0,0,0,0,0,0,0,0,0,0,0,0,0,0,0,0,0,0,0,0,0,0,0,0,0,0,0,0,0,0,0,0,0,0,0,0,0,0,0,0,0,0,0,0,0,0,0,0,0,0,0,0,0,0,0,0,0,0,0,1,2,25,26,7,19,7,20,17,20,81,82,53,53,11,12,
0,0,0,0,0,0,0,0,0,0,0,0,0,0,0,0,0,0,0,0,0,0,0,0,0,0,0,0,0,0,0,0,0,0,0,0,0,0,0,0,0,0,0,0,0,0,0,0,0,0,0,0,0,0,0,0,0,0,0,0,0,0,0,0,0,0,0,0,0,0,0,0,0,0,0,0,0,0,0,0,0,0,0,0,0,0,0,0,0,0,0,0,0,0,0,0,0,0,0,0,0,0,0,0,0,0,0,0,0,0,0,0,0,0,0,0,0,0,0,0,0,0,0,0,0,0,0,0,0,0,0,0,0,0,0,0,0,0,0,0,0,0,0,0,1,27,3,4,28,29,30,31,5,6,3,4,5,6,32,12,
0,0,0,0,0,0,0,0,0,0,0,0,0,0,0,0,0,0,0,0,0,0,0,0,0,0,0,0,0,0,0,0,0,0,0,0,0,0,0,0,0,0,0,0,0,0,0,0,0,0,0,0,0,0,0,0,0,0,0,0,0,0,0,0,0,0,0,0,0,0,0,0,0,0,0,0,0,0,0,0,0,0,0,0,0,0,0,0,0,0,0,0,0,0,0,0,0,0,0,0,0,0,0,0,0,0,0,0,0,0,0,0,0,0,0,0,0,0,0,0,0,0,0,0,0,0,0,0,0,0,0,0,0,0,0,0,0,0,0,0,0,0,0,0,33,2,15,16,34,24,35,36,17,18,15,16,17,18,11,37,
0,0,0,0,0,0,0,0,0,0,0,0,0,0,0,0,0,0,0,0,0,0,0,0,0,0,0,0,0,0,0,0,0,0,0,0,0,0,0,0,0,0,0,0,0,0,0,0,0,0,0,0,0,0,0,0,0,0,0,0,0,0,0,0,0,0,0,0,0,0,0,0,0,0,0,0,0,0,0,0,0,0,0,0,0,0,0,0,0,0,0,0,0,0,0,0,0,0,0,0,0,0,0,0,0,0,0,0,0,0,0,0,0,0,0,0,0,0,0,0,0,0,0,0,0,0,0,0,0,0,0,0,0,0,0,0,0,0,0,0,0,0,0,0,1,2,38,39,7,36,7,9,40,9,43,29,30,31,11,12,
0,0,0,0,0,0,0,0,0,0,0,0,0,0,0,0,0,0,0,0,0,0,0,0,0,0,0,0,0,0,0,0,0,0,0,0,0,0,0,0,0,0,0,0,0,0,0,0,0,0,0,0,0,0,0,0,0,0,0,0,0,0,0,0,0,0,0,0,0,0,0,0,0,0,0,0,0,0,0,0,0,0,0,0,0,0,0,0,0,0,0,0,0,0,0,0,0,0,0,0,0,0,0,0,0,0,0,0,0,0,0,0,0,0,0,0,0,0,0,0,0,0,0,0,0,0,0,0,0,0,0,0,0,0,0,0,0,0,0,0,0,0,0,0,1,2,25,26,7,49,7,20,17,20,51,19,52,53,11,12,
0,0,0,0,0,0,0,0,0,0,0,0,0,0,0,0,0,0,0,0,0,0,0,0,0,0,0,0,0,0,0,0,0,0,0,0,0,0,0,0,0,0,0,0,0,0,0,0,0,0,0,0,0,0,0,0,0,0,0,0,0,0,0,0,0,0,0,0,0,0,0,0,0,0,0,0,0,0,0,0,0,0,0,0,0,0,0,0,0,0,0,0,0,0,0,0,0,0,0,0,0,0,0,0,0,0,0,0,0,0,0,0,0,0,0,0,0,0,0,0,0,0,0,0,0,0,0,0,0,0,0,0,0,0,0,0,0,0,0,0,0,0,0,0,1,83,56,57,56,57,56,62,59,59,63,8,64,53,65,12,
0,0,0,0,0,0,0,0,0,0,0,0,0,0,0,0,0,0,0,0,0,0,0,0,0,0,0,0,0,0,0,0,0,0,0,0,0,0,0,0,0,0,0,0,0,0,0,0,0,0,0,0,0,0,0,0,0,0,0,0,0,0,0,0,0,0,0,0,0,0,0,0,0,0,0,0,0,0,0,0,0,0,0,0,0,0,0,0,0,0,0,0,0,0,0,0,0,0,0,0,0,0,0,0,0,0,0,0,0,0,0,0,0,0,0,0,0,0,0,0,0,0,0,0,0,0,0,0,0,0,0,0,0,0,0,0,0,0,0,0,0,0,0,0,84,67,68,67,68,67,68,71,72,53,63,19,52,53,68,73,
0,0,0,0,0,0,0,0,0,0,0,0,0,0,0,0,0,0,0,0,0,0,0,0,0,0,0,0,0,0,0,0,0,0,0,0,0,0,0,0,0,0,0,0,0,0,0,0,0,0,0,0,0,0,0,0,0,0,0,0,0,0,0,0,0,0,0,0,0,0,0,0,0,0,0,0,0,0,0,0,0,0,0,0,0,0,0,0,0,0,0,0,0,0,0,0,0,0,0,0,0,0,0,0,0,0,0,0,0,0,0,0,0,0,0,0,0,0,0,0,0,0,0,0,0,0,0,0,0,0,0,0,0,0,0,0,0,0,0,0,0,0,0,0,74,75,76,75,76,75,76,75,77,53,63,8,64,53,76,79,
0,0,0,0,0,0,0,0,0,0,0,0,0,0,0,0,0,0,0,0,0,0,0,0,0,0,0,0,0,0,0,0,0,0,0,0,0,0,0,0,0,0,0,0,0,0,0,0,0,0,0,0,0,0,0,0,0,0,0,0,0,0,0,0,0,0,0,0,0,0,0,0,0,0,0,0,0,0,0,0,0,0,0,0,0,0,0,0,0,0,0,0,0,0,0,0,0,0,0,0,0,0,0,0,0,0,0,0,0,0,0,0,0,0,0,0,0,0,0,0,0,0,0,0,0,0,0,0,0,0,0,0,0,0,0,0,0,0,0,0,0,0,0,0,0,0,0,0,0,0,0,0,0,0,63,19,52,0,0,0,
0,0,0,0,0,0,0,0,0,0,0,0,0,0,0,0,0,0,0,0,0,0,0,0,0,0,0,0,0,0,0,0,0,0,0,0,0,0,0,0,0,0,0,0,0,0,0,0,0,0,0,0,0,0,0,0,0,0,0,0,0,0,0,0,0,0,0,0,0,0,0,0,0,0,0,0,0,0,0,0,1,2,3,4,7,8,7,9,5,6,3,4,5,6,7,8,7,9,3,4,40,9,7,7,40,9,38,39,40,9,38,39,40,9,7,8,10,21,7,9,40,9,38,39,40,9,38,39,40,9,38,39,40,9,38,39,40,9,38,39,40,9,38,39,40,9,38,39,40,9,38,39,40,9,63,8,64,53,11,12,
0,0,0,0,0,0,0,0,0,0,0,0,0,0,0,0,0,0,0,0,0,0,0,0,0,0,0,0,0,0,0,0,0,0,0,0,0,0,0,0,0,0,0,0,0,0,0,0,0,0,0,0,0,0,0,0,0,0,0,0,0,0,0,0,0,0,0,0,0,0,0,0,0,0,0,0,0,0,0,0,13,14,15,16,7,19,7,20,17,18,15,16,17,18,7,19,7,20,15,16,17,20,7,7,17,20,25,26,17,20,25,26,17,20,7,19,21,10,7,20,17,20,25,26,17,20,25,26,17,20,25,26,17,20,25,26,17,20,25,26,17,20,25,26,17,20,25,26,17,20,25,26,17,20,63,19,52,53,22,23,
0,0,0,0,0,0,0,0,0,0,0,0,0,0,0,0,0,0,0,0,0,0,0,0,0,0,0,0,0,0,0,0,0,0,0,0,0,0,0,0,0,0,0,0,0,0,0,0,0,0,0,0,0,0,0,0,0,0,0,0,0,0,0,0,0,0,0,0,0,0,0,0,0,0,0,0,0,0,0,0,1,2,38,39,7,8,7,9,40,9,38,39,40,9,7,8,7,9,38,39,5,6,7,7,5,6,43,29,29,29,30,31,5,6,7,8,10,21,7,9,5,6,3,4,5,6,3,4,5,6,3,4,5,6,3,4,5,6,3,4,5,6,3,4,5,6,3,4,5,6,3,4,5,6,63,8,64,53,11,12,
0,0,0,0,0,0,0,0,0,0,0,0,0,0,0,0,0,0,0,0,0,0,0,0,0,0,0,0,0,0,0,0,0,0,0,0,0,0,0,0,0,0,0,0,0,0,0,0,0,0,0,0,0,0,0,0,0,0,0,0,0,0,0,0,0,0,0,0,0,0,0,0,0,0,0,0,0,0,0,0,1,2,25,26,7,19,7,20,17,20,25,26,17,20,7,19,7,20,25,26,17,18,7,7,17,18,51,19,21,7,52,53,17,18,7,19,21,10,7,20,17,18,15,16,17,18,15,16,17,18,15,16,17,18,15,16,17,18,15,16,17,18,15,16,17,18,15,16,17,18,15,16,17,18,63,19,52,53,11,12,
0,0,0,0,0,0,0,0,0,0,0,0,0,0,0,0,0,0,0,0,0,0,0,0,0,0,0,0,0,0,0,0,0,0,0,0,0,0,0,0,0,0,0,0,0,0,0,0,0,0,0,0,0,0,0,0,0,0,0,0,0,0,0,0,0,0,0,0,0,0,0,0,0,0,0,0,0,0,0,0,1,27,3,4,7,8,7,9,5,6,43,29,30,31,7,8,7,9,3,4,40,9,7,42,40,9,63,8,10,7,64,53,40,9,28,29,29,29,30,31,40,9,38,39,40,9,38,39,40,9,38,39,40,9,38,39,40,9,38,39,40,9,41,29,29,29,29,29,29,30,38,39,40,9,80,8,64,53,32,12,
0,0,0,0,0,0,0,0,0,0,0,0,0,0,0,0,0,0,0,0,0,0,0,0,0,0,0,0,0,0,0,0,0,0,0,0,0,0,0,0,0,0,0,0,0,0,0,0,0,0,0,0,0,0,0,0,0,0,0,0,0,0,0,0,0,0,0,0,0,0,0,0,0,0,0,0,0,0,0,0,33,2,15,16,7,19,7,20,17,18,51,19,52,53,7,19,7,20,15,16,17,20,7,50,17,20,63,19,21,7,52,53,17,20,34,24,24,24,35,36,17,20,25,26,17,20,25,26,17,20,25,26,17,20,25,26,17,20,25,26,17,20,46,47,47,47,47,47,47,48,25,26,17,20,81,82,53,53,11,37,
0,0,0,0,0,0,0,0,0,0,0,0,0,0,0,0,0,0,0,0,0,0,0,0,0,0,0,0,0,0,0,0,0,0,0,0,0,0,0,0,0,0,0,0,0,0,0,0,0,0,0,0,0,0,0,0,0,0,0,0,0,0,0,0,0,0,0,0,0,0,0,0,0,0,0,0,0,0,0,0,1,2,38,39,28,29,30,31,40,9,63,8,64,53,28,29,29,29,30,31,5,6,7,7,5,6,85,8,10,7,64,53,5,6,7,8,10,21,7,9,28,29,29,29,29,29,29,29,30,31,3,4,5,6,3,4,5,6,41,29,29,29,58,47,47,47,47,48,5,6,3,4,5,6,3,4,5,6,11,12,
0,0,0,0,0,0,0,0,0,0,0,0,0,0,0,0,0,0,0,0,0,0,0,0,0,0,0,0,0,0,0,0,0,0,0,0,0,0,0,0,0,0,0,0,0,0,0,0,0,0,0,0,0,0,0,0,0,0,0,0,0,0,0,0,0,0,0,0,0,0,0,0,0,0,0,0,0,0,0,0,1,2,25,26,34,24,35,36,17,20,63,19,52,53,34,24,24,24,35,36,17,18,7,7,17,18,86,19,21,7,52,53,17,18,7,19,21,10,7,20,87,10,21,7,24,24,7,10,52,53,15,16,17,18,15,16,17,18,46,47,47,47,47,47,47,47,47,47,17,18,15,16,17,18,15,16,17,18,11,12,
0,0,0,0,0,0,0,0,0,0,0,0,0,0,0,0,0,0,0,0,0,0,0,0,0,0,0,0,0,0,0,0,0,0,0,0,0,0,0,0,0,0,0,0,0,0,0,0,0,0,0,0,0,0,0,0,0,0,0,0,0,0,0,0,0,0,0,0,0,0,0,0,0,0,0,0,0,0,0,0,1,83,56,62,59,59,59,59,59,59,63,8,64,53,59,59,59,59,59,59,59,59,28,30,59,59,88,8,10,7,64,53,40,9,7,8,10,21,7,9,89,21,10,7,40,9,7,8,64,53,59,59,60,57,56,57,41,29,58,47,47,47,47,47,47,48,56,62,59,59,59,59,59,59,59,59,60,57,65,12,
0,0,0,0,0,0,0,0,0,0,0,0,0,0,0,0,0,0,0,0,0,0,0,0,0,0,0,0,0,0,0,0,0,0,0,0,0,0,0,0,0,0,0,0,0,0,0,0,0,0,0,0,0,0,0,0,0,0,0,0,0,0,0,0,0,0,0,0,0,0,0,0,0,0,0,0,0,0,0,0,84,67,68,71,72,53,53,53,53,53,63,19,52,53,53,53,53,53,53,53,53,53,34,35,53,53,88,19,21,7,52,53,17,20,7,19,21,10,7,20,87,10,21,7,17,20,7,19,52,53,53,53,53,70,68,67,69,47,47,47,47,47,47,47,47,47,68,71,72,53,53,53,53,53,53,53,53,70,68,73,
0,0,0,0,0,0,0,0,0,0,0,0,0,0,0,0,0,0,0,0,0,0,0,0,0,0,0,0,0,0,0,0,0,0,0,0,0,0,0,0,0,0,0,0,0,0,0,0,0,0,0,0,0,0,0,0,0,0,0,0,0,0,0,0,0,0,0,0,0,0,0,0,0,0,0,0,0,0,0,0,74,75,76,75,77,53,53,53,53,53,63,8,64,53,53,53,53,53,53,53,53,53,7,7,53,53,88,8,10,7,64,53,5,6,7,8,10,21,7,9,89,21,10,7,5,6,7,8,64,53,53,53,53,78,76,75,76,75,76,75,76,75,76,75,76,75,76,75,77,53,53,53,53,53,53,53,53,78,76,79,
0,0,0,0,0,0,0,0,0,0,0,0,0,0,0,0,0,0,0,0,0,0,0,0,0,0,0,0,0,0,0,0,0,0,0,0,0,0,0,0,0,0,0,0,0,0,0,0,0,0,0,0,0,0,0,0,0,0,0,0,0,0,0,0,0,0,0,0,0,0,0,0,0,0,0,0,0,0,0,0,0,0,0,0,0,0,0,0,0,0,63,19,52,0,0,0,0,0,0,0,0,0,0,0,0,0,0,0,0,0,0,0,0,0,0,0,0,0,0,0,0,0,0,0,0,0,0,0,0,0,0,0,0,0,0,0,0,0,0,0,0,0,0,0,0,0,0,0,0,0,0,0,0,0,0,0,0,0,0,0,
1,2,3,4,5,6,3,4,7,8,7,9,5,6,7,8,10,7,3,4,5,6,3,4,5,6,3,4,5,6,3,4,5,6,3,4,5,6,3,4,5,6,3,4,89,21,64,53,5,6,3,4,5,6,3,4,5,6,7,7,5,6,3,4,5,6,3,4,5,6,3,4,5,6,3,4,5,6,3,4,5,6,3,4,5,6,7,7,5,6,63,8,64,53,11,12,0,0,0,0,0,0,0,0,0,0,0,0,0,0,0,0,0,0,0,0,0,0,0,0,0,0,0,0,0,0,0,0,0,0,0,0,0,0,0,0,0,0,0,0,0,0,0,0,0,0,0,0,0,0,0,0,0,0,0,0,0,0,0,0,
13,14,15,16,17,18,15,16,7,19,7,20,17,18,7,19,21,7,15,16,17,18,15,16,17,18,15,16,17,18,15,16,17,18,15,16,17,18,15,16,17,18,15,16,87,10,52,53,17,18,15,16,17,18,15,16,17,18,7,7,17,18,15,16,17,18,15,16,17,18,15,16,17,18,15,16,17,18,15,16,17,18,15,16,17,18,7,7,17,18,63,19,52,53,22,23,0,0,0,0,0,0,0,0,0,0,0,0,0,0,0,0,0,0,0,0,0,0,0,0,0,0,0,0,0,0,0,0,0,0,0,0,0,0,0,0,0,0,0,0,0,0,0,0,0,0,0,0,0,0,0,0,0,0,0,0,0,0,0,0,
1,2,38,39,40,9,38,39,7,8,7,9,40,9,7,8,10,7,24,24,24,24,24,24,24,24,24,24,24,24,24,24,24,24,24,24,24,24,24,24,24,24,24,24,89,21,64,53,24,24,24,24,24,24,24,24,24,24,7,7,40,9,38,39,40,9,38,39,40,9,38,39,40,9,38,39,43,29,30,31,40,9,38,39,40,9,7,7,40,9,63,8,64,53,11,12,0,0,0,0,0,0,0,0,0,0,0,0,0,0,0,0,0,0,0,0,0,0,0,0,0,0,0,0,0,0,0,0,0,0,0,0,0,0,0,0,0,0,0,0,0,0,0,0,0,0,0,0,0,0,0,0,0,0,0,0,0,0,0,0,
1,2,25,26,17,20,25,26,7,19,7,20,17,20,7,19,21,7,25,26,17,20,25,26,17,20,25,26,17,20,25,26,17,20,25,26,17,20,25,26,17,20,25,26,87,10,52,53,17,20,25,26,17,20,25,26,17,20,7,7,17,20,25,26,17,20,25,26,17,20,25,26,17,20,25,26,51,19,52,53,17,20,25,26,17,20,7,7,17,20,63,19,52,53,11,12,0,0,0,0,0,0,0,0,0,0,0,0,0,0,0,0,0,0,0,0,0,0,0,0,0,0,0,0,0,0,0,0,0,0,0,0,0,0,0,0,0,0,0,0,0,0,0,0,0,0,0,0,0,0,0,0,0,0,0,0,0,0,0,0,
1,27,3,4,5,6,3,4,7,8,7,9,5,6,7,8,10,7,3,4,5,6,3,4,5,6,3,4,5,6,3,4,5,6,3,4,5,6,3,4,5,6,3,4,89,21,64,53,5,6,3,4,5,6,3,4,5,6,7,7,5,6,28,29,29,29,29,29,30,31,3,4,5,6,3,4,63,8,64,53,5,6,3,4,5,6,7,42,5,6,85,8,64,53,32,12,0,0,0,0,0,0,0,0,0,0,0,0,0,0,0,0,0,0,0,0,0,0,0,0,0,0,0,0,0,0,0,0,0,0,0,0,0,0,0,0,0,0,0,0,0,0,0,0,0,0,0,0,0,0,0,0,0,0,0,0,0,0,0,0,
33,2,15,16,17,18,15,16,7,19,7,20,17,18,7,19,21,7,15,16,17,18,15,16,17,18,15,16,17,18,15,16,17,18,15,16,17,18,15,16,17,18,15,16,87,10,52,53,17,18,15,16,17,18,15,16,17,18,7,7,17,18,87,10,21,7,7,10,52,53,15,16,17,18,15,16,63,19,52,53,17,18,15,16,17,18,7,50,17,18,86,19,52,53,11,37,0,0,0,0,0,0,0,0,0,0,0,0,0,0,0,0,0,0,0,0,0,0,0,0,0,0,0,0,0,0,0,0,0,0,0,0,0,0,0,0,0,0,0,0,0,0,0,0,0,0,0,0,0,0,0,0,0,0,0,0,0,0,0,0,
1,2,38,39,40,9,38,39,7,8,7,36,40,9,7,8,10,7,38,39,41,29,29,30,3,4,38,39,40,9,41,29,29,29,29,30,40,9,38,39,40,9,38,39,89,21,64,53,40,9,38,39,40,9,38,39,40,9,7,42,40,9,89,21,10,7,7,8,64,53,38,39,40,9,38,39,85,8,64,53,40,9,38,39,40,9,7,7,40,9,88,8,64,53,11,12,0,0,0,0,0,0,0,0,0,0,0,0,0,0,0,0,0,0,0,0,0,0,0,0,0,0,0,0,0,0,0,0,0,0,0,0,0,0,0,0,0,0,0,0,0,0,0,0,0,0,0,0,0,0,0,0,0,0,0,0,0,0,0,0,
44,45,25,26,17,20,25,26,7,19,7,49,17,20,7,19,21,7,25,26,46,47,47,48,15,16,25,26,17,20,46,47,47,47,47,48,17,20,25,26,17,20,25,26,87,10,52,53,17,20,25,26,17,20,25,26,17,20,7,50,17,20,87,10,21,7,7,19,52,53,25,26,17,20,25,26,86,19,52,53,17,20,25,26,17,20,7,7,17,20,88,19,52,53,11,12,0,0,0,0,0,0,0,0,0,0,0,0,0,0,0,0,0,0,0,0,0,0,0,0,0,0,0,0,0,0,0,0,0,0,0,0,0,0,0,0,0,0,0,0,0,0,0,0,0,0,0,0,0,0,0,0,0,0,0,0,0,0,0,0,
54,55,56,57,56,57,56,57,56,57,56,57,56,57,56,57,41,29,29,29,58,47,47,47,61,29,29,29,29,29,58,47,47,47,47,47,61,29,29,30,56,57,56,57,90,21,64,91,56,57,56,62,59,59,60,57,56,62,59,59,59,59,89,21,10,7,7,8,64,53,60,57,56,57,56,57,92,8,64,91,56,57,56,57,56,57,56,62,59,59,88,8,64,53,65,12,0,0,0,0,0,0,0,0,0,0,0,0,0,0,0,0,0,0,0,0,0,0,0,0,0,0,0,0,0,0,0,0,0,0,0,0,0,0,0,0,0,0,0,0,0,0,0,0,0,0,0,0,0,0,0,0,0,0,0,0,0,0,0,0,
66,67,68,67,68,67,68,67,68,67,68,67,68,67,68,67,69,47,47,47,47,47,47,47,47,47,47,47,47,47,47,47,47,47,47,47,47,47,47,48,68,67,68,67,68,67,68,67,68,67,68,71,72,53,53,70,68,71,72,53,53,53,87,10,21,7,7,19,52,53,53,70,68,67,68,67,68,67,68,67,68,67,68,67,68,67,68,71,72,53,88,19,52,53,68,73,0,0,0,0,0,0,0,0,0,0,0,0,0,0,0,0,0,0,0,0,0,0,0,0,0,0,0,0,0,0,0,0,0,0,0,0,0,0,0,0,0,0,0,0,0,0,0,0,0,0,0,0,0,0,0,0,0,0,0,0,0,0,0,0,
74,75,76,75,76,75,76,75,76,75,76,75,76,75,76,75,76,75,76,75,76,75,76,75,76,75,76,75,76,75,76,75,76,75,76,75,76,75,76,75,76,75,76,75,76,75,76,75,76,75,76,75,77,53,53,78,76,75,77,53,53,53,89,21,10,7,7,8,64,53,53,78,76,75,76,75,76,75,76,75,76,75,76,75,76,75,76,75,77,53,88,8,64,53,76,79,0,0,0,0,0,0,0,0,0,0,0,0,0,0,0,0,0,0,0,0,0,0,0,0,0,0,0,0,0,0,0,0,0,0,0,0,0,0,0,0,0,0,0,0,0,0,0,0,0,0,0,0,0,0,0,0,0,0,0,0,0,0,0,0,
