39,11,16,
0,1,2,3,4,3,5,3,4,3,5,3,5,6,0,1,
1,2,2,7,8,9,10,11,8,9,10,11,12,6,6,0,
2,2,2,13,8,14,10,15,8,14,10,13,16,6,6,6,
2,2,2,11,8,9,10,17,8,9,10,18,13,6,6,6,
2,2,2,13,8,14,10,19,8,14,10,20,11,6,6,6,
2,2,2,11,8,9,10,21,8,9,10,18,13,6,6,6,
2,2,2,13,22,23,24,11,22,23,24,11,12,6,25,6,
2,2,2,3,4,3,5,3,4,3,5,3,5,6,26,6,
2,2,27,28,29,29,28,30,28,30,28,31,32,33,26,6,
2,27,34,30,28,29,29,28,30,28,30,28,35,36,37,6,
2,34,28,30,28,30,29,29,28,30,28,30,31,32,38,6,
