41,11,16,
0,1,2,3,3,4,5,6,7,8,2,3,9,10,7,11,
8,12,3,3,4,13,3,3,8,14,3,3,3,15,7,8,
14,16,17,18,19,20,17,18,5,6,3,19,9,10,7,11,
21,8,3,20,3,3,3,20,3,3,20,20,3,15,7,8,
14,16,3,19,17,18,3,4,19,20,19,20,9,10,7,11,
21,8,3,20,3,20,4,13,3,3,3,3,3,15,7,8,
0,22,23,3,19,20,19,3,17,18,19,3,9,10,7,11,
8,24,25,26,3,3,27,26,3,20,27,26,3,15,7,8,
0,28,29,30,31,31,32,33,31,31,34,30,31,31,7,11,
8,35,36,37,38,37,38,37,38,37,39,37,38,37,7,8,
0,1,8,0,40,21,14,16,40,21,8,0,40,21,14,16,
