2	16
256	210
0	0	0	0	0	1	2	3	4	5	6	7	8	9	10	11	12	13	14	15	16	17	18	19	23
0	1	0	0	20	21	22	24	25	26	27	28	29	30	31	32	33	34	35	36
0	2	0	0	37	38	39	40	41	42	43	44	45	46	47	48	49	50	51	52	216	217	219	220	238
0	3	0	0	53	54	55	56	57	58	59	60	61	62	63	64	65	66	67	68	221
0	4	0	0	69	70	71	72	73	74
0	5	0	0	75	76	77	78	79	80
0	6	0	0	81	82	83	84	85	86	87	88	89	90	91	92	93	224
0	7	0	0	94	95	96	97	98	99	100	101
0	8	0	0	102	103	104	105	106	107	108	109	110	111
0	9	0	0	112	113	114	115	116	117	118	119	120	121	122	123	124	125	126	127	147	148	149
0	10	0	0	128	129	130	131	132	133	134	135	136	137	138	139	140	141	142	150	151	152	153	154	155	156	157	158	160	161	232
0	11	0	0	162	163	164	165	166	167
0	12	0	0	175
0	13	0	0	176	177
0	14	0	0	178	179	180	181	182	183	184	185	186	187	188	189	190	191	192	236
0	15	0	0	193	194	195	196	197	198	199	200	201	202	203	204	205	206	207	208	209	210	211	212	213	214	215	237
1	0	210	0
1	1	210	0
1	2	210	0
1	3	210	0
1	4	210	0	222
1	5	210	0	223
1	6	210	0
1	7	210	0	225	226
1	8	210	0	227
1	9	210	0	228
1	10	210	0	229
1	11	210	0	168	169	170	171	172	173	174	230	231
1	12	210	0	233
1	13	210	0	234
1	14	210	0	235
1	15	210	0
